111111
10E111
100P01
1C0001
111111
