11111111111111111111111111
10000000000000000000000001
100000111111000000E0000001
10000010000100000000000001
1000001000010000P000000001
10000010000100000000000001
1000001000010000C000000001
10000010000100000000000001
10000010000100000000000001
11111111111111111111111111