1111111
10C0001
101E0P1
1111111
