111111111111111111111111111111111111
10C000000000000000000111110000000001
100000000000000000000000010000000001
101E0P111100000000000000000000000001
100000000000000111000000100000001111
100000000000000000000000000000000001
111111111111111111111111111111111111
