111111111111111111111111111111111111
10C000000000000000000111110000000001
10010100000000000000000001000000C001
101E1P111100000000000000000000000001
100101000000000111000000100000001111
1000000C0000000000000000000000000001
111111111111111111111111111111111111
