1111111
10C0P01
101E001
1111111
