111111111111111111111111111111111111
10C000000000000000000111110000E00001
100101000000C0000000000001000000C001
101010111100000000000000000000000001
100101000000000111000000100000001111
10P0000C0000000000000000000000000001
111111111111111111111111111111111111
