1111111
10C0P01
101E0P1
1111111
