111111
1E00P11
10C0011
1111111