1111111
1000P11
100001
1111111