1111111111
10PEC00001
1000000001
1111011111
